################
##i====#########
##========######
##==###===######
##==###===######
##==###===######
##==###===######
##==###===######
##==###===######
##==###========#
##==###========#
##==###========#
##==p##========#
#######=======o#
################
################
