################################
#====#########=======i##########
#==#==########========####====##
#==#==########========####====##
#==#==########========####====##
#==#==########========####====##
#==#==########========####====##
#==#==########========####====##
#==#==########========####====##
#==#==########========####====##
#==#==================####====##
#==#==================####====##
#==####==#####========####====##
#==####==#####========####====##
#==####==#######==########====##
#==####==##p=###==########====##
#==####==##==###==########====##
#==####==##==###==########====##
#==####==##==###==########====##
#==####==##==###==########====##
#==####==##==###==########====##
#==####==##==###==########====##
#==####==##==###==########====##
#o=####==##==###==########====##
#######==##==###==########====##
#######==##==###==########====##
#######======###==########====##
#######==#######==########====##
#######==#######==============##
#######==#######==============##
#######==#######===========#####
################################
