################################
##p============================#
#############==================#
##========##################===#
#=========##################===#
########==##################===#
########==##################===#
########==##################===#
#####==========================#
###===========================##
###==###########################
###==####=====================##
###==####====################==#
###==####===============#####==#
###==##############===#######==#
###============i###===#######==#
###============####===#######==#
###########====####===#######==#
###########====####===#######==#
###########====####===#######==#
###########====####===#######==#
###########====####===#######==#
###########====####===#######==#
###########====####===#######==#
###########====####===#######==#
###########====####======####==#
###########==###=========o###==#
###########==###=========####==#
###########==################==#
###########====================#
###########====================#
################################
