################
##=====####=o==#
##========####=#
#######===####=#
#######===###==#
##p####===###==#
##=####===###==#
##=####===###==#
##==###===###==#
##==###===#====#
##==###===#====#
##==###===#====#
##===##===#====#
#i=============#
################
################
